######################
#..........T.........#
#O.....>.......<..tt.#
#....................#
##########+#######+###
         #.#     #.#
         #.#######.#
         #.........#
         #.....tt..#
         #.........#
         ###########

' ' = None
'#' = Wall
'.' = Floor
'+' = Door
'<' = Upstair
'>' = Downstair
'O' = Oven
'T' = Toilet
't' = Table
