CH|H|HTHHHHHHHHHHHHH|H|HHHC
H():::H...[90]..,,,,,,W,,,H
|:::::-.........,,,,,,,,,,|
H():::H.........,,,,,,,,,,|
THH|HHC.........,,,,o,,,,SH
H...............F111O11111H
|.c.............CHHHHHHHHHT
Ht..............Hp;;;;;;;;H
|.c.............-;;;;;;;;uH
H...............H;;s;;;;;;H
CHHHHHHHHH-HHHHHTHHH|HH|HHC
