################################
#..........T.........#.........#
#O.....>.......<..tt.#.........#
#....................#.........#
##########+#######+###.........#
         #.#     #.#...........#
         #.#######.#......######
         #.........+......#
         #.....tt..########
         #.........#
         ##+########
          #.#
          #.#
          #.#
          #.#
          #.#################
          #.................#
          #.#################
          #.#
          #.#
          #.#######
          #.......#
          #.......#
          #########
