    CHHHHHHC
    H......H
    |..>...H
    |......|
    H......H
CH|HC......|
H..........H
|...:::....|
|s..:::...SH
|..........|
H...u...p..H
CHH|H|H|H|HC
