CHHHHHHHHHHHHHHHHHHHHHHHHHC
H().......[90]..,,,,,,W,,,H
H().............,,,,,,,,,,H
H...............,,,,,,,,,,H
H...............,,,,o,,,,SH
H...............F111O11111H
H.c.............CHHHHHHHHHT
Ht..............Hp;;;;;;;;H
H.c.............+;;;;;;;;uH
H...............H;;s;;;;;;H
CHHHHHHHHH-HHHHHTHHHHHHHHHC
