CHHHTHHHHHHC
H...H......H
H...H..<...H
H...-......H
H...H......H
TH-HTHHHHHHT
H..........H
H..........H
H..........H
H...,o,,,,,H
H...,O,,S,,H
CHHHHHHHHHHC
