###########################
#((...v...[90]..,,,,,,W,,,#
#)).............,,,,,,,,,,#
#...............,,,,,,,,,,#
#...............f,,,o,,,,S#
#...............F111O11111#
#.c.............###########
#t..............#p;;;;;;;;#
#.c.............+;;;;;;;;u#
#...............#,,s,,,,,,#
#############+#############