EhhhhhhhhhhhhhhhhhhhhhhhhhE
h((.......[90]..,,,,,,W,,,h
h)).............,,,,,,,,,,h
h...............,,,,,,,,,,h
h...............f,,,o,,,,Sh
h...............F111O11111h
h.c.............hhhhhhhhhhT
ht..............hp;;;;;;;;h
h.c.............+;;;;;;;;uh
h...............h,,s,,,,,,h
Ehhhhhhhhh-hhhhhhhhhhhhhhhE