###########################
#00.............v.........#
#BB......................O#
#........................W#
#.........................#
#M........................#
#...............###########
#t..............#{}.......#
#...............+.......T.#
#...............#..s......#
#############+#############